francois hollande : fhollande
nicolas sarkozy : nicolassarkozy
marine le pen : mlp_officiel
jean-luc mélenchon : jlmelenchon
nkm : nk_m
najat belkacem : najatvb
anne hidalgo : anne_hidalgo
arnaud montebourg : montebourg
francois bayrou : bayrou
cecile duflot : cecileduflot
segolene royal : royalsegolene
fleur pellerin : fleurpellerin
benoit hamon : benoithamon
francois fillon : francoisfillon
jean francois cope : jf_cope
christianne taubira : chtaubira
alain juppe : alainjuppe
manuel valls : manuelvalls
valerie pecresse : vpecresse
martine aubry : martineaubry
eelv : eelv
ump : ump
nadine morano : nadine__morano
eva joly : evajoly
parti socialiste : partisocialiste
rachida dati : datirachida
christine boutin : christineboutin
bruno le maire : bruno_lemaire
mouvement democrate : modem
front national : fn_officiel
harlem desir : harlemdesir