eminem : eminem
nas : nas
jay z : s_c_
ice cube : icecube
snoop dogg : snoopdogg
dr dre : drdre
rakim : ericbandrakim
kendrick lamar : kendricklamar
dmx : dmx
50 cent : 50cent
kanye west : kanyewest
busta rhymes : bustarhymes
krs one : IamkrsOne
mos def : mosdefofficial
ludacris : ludacris
method man : methodman
T.I. : tip
common : common
scarface : brothermob
ghostface killah : ghostfacekillah
talib kweli : talibkweli
lupe fiasco : lupefiasco
raekwon : raekwon
j. cole : jcolenc
gza : therealgza
Lauryn hill : mslaurynhill
Chuck D : mrchuckd
lil wayne : liltunechi
big boi : bigboi
immortal technique : immortaltech
rza : rza
q-tip : qtiptheabstract
drake : drake
xzibit : xzibit
tech n9ne : techn9ne
guru : gurugangstarr
kid cudi : kidcudi
jadakiss : therealkiss
wiz khalifa : wizkhalifa
the game : thegame
fabolous : myfabolouslife
warren g : regulator
twista : twistagmg
b.o.b. : bobatl
missy eliot : missyelliott
young jeezy : youngjeezy
lil'kim : lilkim
too short : tooshort
big sean : bigsean
action bronson : actionbronson
rick ross : rickyrozay
schoolboy q : schoolboyq
asap rocky : asvpxrocky
asap ferg : asapferg
pusha t : pusha_t
tech n9ne : techn9ne
tyler the creator : fucktyler
hopsin : hopsin
lloyd banks : lloydbanks
tony yayo : tonyyayo
eve : therealeve
katty got bandz : katiegotbandz
mobb deep : mobbdeep
nicki minaj : nickiminaj
grandmaster flash : djflash4eva
machine gun kelly : machinegunkelly
kid ink : kid_ink
lil durk : lildurk_
lil reese : lilreese300
dreezy : dreezydreezy
chief keef : chiefkeef
chance the rapper : chancetherapper
wale : wale
meek mill : meekmill
p diddy : iamdiddy
young jeezy : youngjeezy
mac miller : macmiller
macklemore : macklemore
young thug : youngthug
juicy j : therealjuicyj
french montana : frenchmontana
tyga : tyga
rich homie quan : richhomiequan
donald glover : donaldglover
gucci mane : gucci1017
2 chainz : 2chainz
macklemore : macklemore
pitbull : pitbull
future : 1future
pharell : Pharrell
iggy azalea : iggyazalea
azealia banks : azealiabanks