Laurent Garnier : laurentgarnier
marine Lorphelin : MarineLorphelin
Sliimy : Sliimy
Johnny Hallyday : JohnnySjh
#Herve Mathoux : MatouxHerve
Gerard Louvin : GLouvin
Christian Audifier : CAudigierBrands
Enora Malagre : EnoraMofficiel
Louis Delort : LouisDelortOff
Dominique Farrugia : farrugiadom
Cartman : CartmanOfficiel
Fabrice Eboue : fabriceeboue
Pascal Obispo : ObispoPascal
Nicolas Bedos : NicolasBedos1
Jean-Roch : JeanRoch
Leila Bekhti : LeilaBekhti
Valerie Benaim : BenaimValerie
Jose Garcia : JoseGarciaOff
#Yelle : Yelletweets
Guillaume Pley : guillaumepley
Julie Brochu-Thomassin : JulieOfficiel26
Fauve Hautot : FauveDanse
Laurence Ferrari : LaurenceFerrari
Woodkid : Woodkid
Bruce Toussaint : Bruce_Toussaint
Bertrand Chameroy : bchameroy
#Neil Narbonne : NeilNarbonne1
Chris Marques : LeChrisMarques
Maude : Maude_Official
Ben l'Oncle Soul : BenOncleSoul
Laury Thilleman : LauryThilleman
Patrick Sébastien : PatSebastien